TTTTTTTTTTTTTTTTTTTTTTTTTTTTTT
T.R..+....T.~.~.~.~.T....R..+T
T.T.T.T.T.T.~.T.T.~.T.T.T.T.TT
T.L.T.T.T.T.~.T.T.~.T.T.T.T.TT
T.*.T.T.T.T.~.T.T.~.T.T.x.T.TT
T.T.T.T.R.R.~.~.~.~.T.T.T.T.TT
T.R.T.R.T.T.~.T.~.T.T.T.T.R.TT
T.T.T.T.T.T.~.~.~.~.T..+.T.+.T
T...T..+...T...T....T....T...T
TTTTTTTTTTTTTTTTTTTTTTTTTTTTTT
