.TTTTTTTTTTTTTTTT.
.TTTTTTTTTTTTTTTT.
T.LTT.xT~+RTTT.+RT
T.R+R~+R..x.TTRRTT
T...RR~~R..R~~R..T
TR.....T..T+RT+..T
TRTTTTTR~TTTRRTx*T
TRTTTTR+RTTTRTR~TT
TT.RRRx~.RRRTT.TTT
T....T*T+T+TT+..TT
T..+.~~~.+RT....RT
.TTTTTTTRRRRTTTTT.
.TTTTTTTTTTTTTTTT.
