.TTTTTTTTTTTTTTTT.
.TTTTTTTTTTTTTTTT.
T.LTT.xT~+RTTT.+RT
T.R+R~+R..x.TTRRTT
T...RR~~R..R~~R..T
TR.....T..T+TT+..T
TRTTTTTR~TTTTRTx*T
TRTTTTR+RTTTRTR~TT
TT.RRRx~.RRRTT.TTT
T....T*T+TTTT+..TT
T..+.~~~.+RT....RT
.TTTTTTTTTRRTTTTT.
.TTTTTTTTTTTTTTTT.