TTTTTTTTTTTTTTTTTTTTTTTTTTTTTTT
T....T....~~~.T.T......~~~~~~~T
T.T+T..R..~+~..T..T.TT.~TTTTT~T
T..T.T....~x~.TT.T..Tx.~TR..T~T
TL........~~~.T.TR.TT..~T.+.T~T
T..TTT....~x~.T........~T..*T~T
T..R+T..R.~~~..TTT.TTTT~TTTTT~T
T....T....~+~.........x~~~~~~~T
TTTTTTTTTTTTTTTTTTTTTTTTTTTTTTT