TTTTTTTTT
T...+...T
T.R.~~..T
T...R.T.T
T.T.LTT.T
T.x...*.T
T...R...T
T.......T
TTTTTTTTT
