TTTTTTTTTTTTTTTTTTTTTTTTTTTTTT
T.R..+....T.W.W.W.W.T....R..+T
T.T.T.T.T.T.W.T.T.W.T.T.T.T.TT
T.L.T.T.T.T.W.T.T.W.T.T.T.T.TT
T.*.T.T.T.T.W.T.T.W.T.T.x.T.TT
T.T.T.T.R.R.W.W.W.W.T.T.T.T.TT
T.R.T.R.T.T.W.T.W.T.T.T.T.R.TT
T.T.T.T.T.T.W.W.W.W.T..+.T.+.T
T...T..+...T...T....T....T...T
TTTTTTTTTTTTTTTTTTTTTTTTTTTTTT



